111111111111111111111111111111111111111111111111
100000000000000000000000000000000000000000000001
10000000000000000000000E000000000000000000000001
100111100111111001111001111000001000001100001001
100100000000100001000001000000010100001010001C01
100111100000100001111001001100111110001001001001
100100000000100001000001100100100010001000101001
100100000000100001111001111001000001001000011001
10000000000000000000000P000000000000000000000001
100000000000CCCCCCCCCCCCCCCC00000000000000000001
111111111111111111111111111111111111111111111111
