1111111
1000001
1E00P01
100CCC1
1CC1101
1111111