111111111111111111111
11CE11111111111111111
11000P110000111101C11
111110011111100000001
1111000C0110001110011
101001000111100000011
10000K11C110011101111
111000100000011101111
11CC110000C1000001111
111111111111111111111
